Item Number 1               Name: Brother's medallion                                 Age:  500 years,   46 days 	Tags: Dangerous,Important,Magic,Remembered,Token,Trinket
Item Number 3               Name: Crumpled sketch of a flying machine                 Age:  281 years,  289 days 	Tags: NonMagic,Safe,Trinket
Item Number 4               Name: Vial of clear oil with a sweet scent                Age:    5 years,  216 days 	Tags: AlchemySupply,NonMagic,RawMaterial,Safe
Item Number 5               Name: Twisted copper spring                               Age:  207 years,  357 days 	Tags: NonMagic,Part,Safe,Tool
Item Number 6               Name: Set of three miniature screwdrivers                 Age:  325 years,  350 days 	Tags: NonMagic,Part,Safe,Tool
Item Number 7               Name: Worn spool of golden thread                         Age:   34 years,   73 days 	Tags: Clothing,NonMagic,Safe
Item Number 8               Name: Pocket-sized folding compass                        Age:  356 years,  130 days 	Tags: Device,NonMagic,Safe,Trinket
Item Number 9               Name: Clay marble with a swirling glaze                   Age:  446 years,  213 days 	Tags: NonMagic,Safe,Trinket
Item Number 10              Name: Paper-wrapped bundle of mixed screws                Age:    0 years,    6 days 	Tags: Part,RawMaterial,Recent,Remembered,Safe
Item Number 11              Name: Tin whistle, slightly dented                        Age:  292 years,  241 days 	Tags: NonMagic,Safe,Trinket
Item Number 12              Name: Sliver of smoked glass                              Age:  311 years,  294 days 	Tags: NonMagic,RawMaterial,Safe
Item Number 13              Name: Tinker's file, dulled with use                      Age:  279 years,    4 days 	Tags: NonMagic,Safe,Tool
Item Number 14              Name: Vial of quick-setting resin                         Age:  392 years,  164 days 	Tags: AlchemySupply,NonMagic,RawMaterial,Safe
Item Number 15              Name: Folded paper fan, painted with stars                Age:  349 years,  283 days 	Tags: NonMagic,Safe,Trinket
Item Number 16              Name: Personal trinket: Tiny silver thimble               Age:  156 years,  143 days 	Tags: Important,Remembered,Trinket
Item Number 17              Name: Drawstring pouch full of buttons                    Age:  169 years,  327 days 	Tags: Clothing,NonMagic,Safe,Trinket
Item Number 18              Name: Wooden cog with burned runes                        Age:  455 years,  264 days 	Tags: Magic,Part,Safe,Tool
Item Number 19              Name: Coil of copper wire                                 Age:  309 years,    9 days 	Tags: NonMagic,Part,RawMaterial,Safe
Item Number 20              Name: Empty inkwell with flecks of turquoise ink          Age:  336 years,  154 days 	Tags: Device,NonMagic,Safe
Item Number 21              Name: Chunk of beeswax                                    Age:   27 years,  249 days 	Tags: NonMagic,RawMaterial,Safe
Item Number 22              Name: Charcoal pencil worn to a nub                       Age:  492 years,   37 days 	Tags: NonMagic,RawMaterial,Safe
Item Number 23              Name: Cloth tape measure (frayed at 42”)                  Age:  340 years,   47 days 	Tags: Clothing,NonMagic,Safe
Item Number 24              Name: Brass monocle with cracked lens                     Age:  303 years,  195 days 	Tags: NonMagic,Safe,Trinket
Item Number 25              Name: Shard of polished sea glass                         Age:  397 years,  243 days 	Tags: NonMagic,Safe,Trinket
Item Number 26              Name: Leather strap with tiny buckles                     Age:  298 years,  180 days 	Tags: Clothing,NonMagic,Safe
Item Number 27              Name: Half-carved figurine of a cat                       Age:   77 years,  359 days 	Tags: NonMagic,Safe,Trinket
Item Number 28              Name: Pouch of dried lavender                             Age:  122 years,  152 days 	Tags: Clothing,NonMagic,Safe
Item Number 29              Name: Folded paper glider with writing on the wing        Age:   38 years,  307 days 	Tags: NonMagic,Safe,Trinket
Item Number 30              Name: Small metal stamp of a leaf                         Age:  440 years,  336 days 	Tags: NonMagic,Part,Safe
Item Number 31              Name: Personal trinket: Feather with metallic sheen       Age:   98 years,  152 days 	Tags: Important,Remembered,Safe,Trinket
Item Number 32              Name: Pair of fine tweezers                               Age:   72 years,  311 days 	Tags: NonMagic,Safe,Tool
Item Number 33              Name: Threaded brass ring (non-magical)                   Age:  258 years,  186 days 	Tags: Clothing,NonMagic,Safe
Item Number 34              Name: Piece of soft felt, indigo-dyed                     Age:  329 years,  296 days 	Tags: Clothing,NonMagic,Safe
Item Number 35              Name: Vial of powdered pigment (ochre)                    Age:  453 years,   28 days 	Tags: AlchemySupply,NonMagic,RawMaterial,Safe
Item Number 36              Name: Pocket sundial                                      Age:   50 years,   89 days 	Tags: Device,NonMagic,Safe
Item Number 37              Name: Small bell with a silent clapper                    Age:  327 years,  201 days 	Tags: Device,NonMagic,Safe
Item Number 38              Name: Wound ball of string, striped                       Age:  492 years,  233 days 	Tags: Clothing,NonMagic,Safe
Item Number 39              Name: Cracked ceramic bead with blue glaze                Age:    9 years,   98 days 	Tags: Recent,Remembered,Safe,Trinket
Item Number 40              Name: Folded scrap of musical notation                    Age:  485 years,   45 days 	Tags: NonMagic,Safe,Trinket
Item Number 41              Name: Fragment of stained glass                           Age:  336 years,  308 days 	Tags: NonMagic,Safe,Trinket
Item Number 42              Name: Length of chain with miniature hook                 Age:  288 years,  177 days 	Tags: NonMagic,Part,Safe,Tool
Item Number 43              Name: Miniature paintbrush (no bristles)                  Age:   76 years,  200 days 	Tags: NonMagic,Safe,Tool
Item Number 44              Name: Carved cork stopper                                 Age:  336 years,  324 days 	Tags: NonMagic,Safe,Trinket
Item Number 45              Name: Sheet of copper foil                                Age:  457 years,   76 days 	Tags: NonMagic,Part,RawMaterial,Safe
Item Number 46              Name: Small box of flint and steel                        Age:  307 years,   78 days 	Tags: NonMagic,Part,Safe,Tool
Item Number 47              Name: Embroidered scrap from an old banner                Age:  240 years,  221 days 	Tags: Clothing,NonMagic,Safe
Item Number 48              Name: Wooden ruler, split in the middle                   Age:  108 years,   32 days 	Tags: NonMagic,Safe,Tool
Item Number 49              Name: Small brass hinge                                   Age:  108 years,  176 days 	Tags: NonMagic,Part,Safe
Item Number 50              Name: Stitched patch shaped like a fox                    Age:   95 years,   70 days 	Tags: Clothing,NonMagic,Safe,Trinket
Item Number 51              Name: Spool of conductive thread                          Age:   67 years,  143 days 	Tags: Clothing,NonMagic,RawMaterial,Safe
Item Number 52              Name: Tuning fork with etched notes                       Age:  412 years,  178 days 	Tags: NonMagic,Safe,Trinket
Item Number 53              Name: Pin of silver shaped like a lily                    Age:  367 years,   47 days 	Tags: NonMagic,Safe,Trinket
Item Number 54              Name: Bent nail saved for “later use”                     Age:  490 years,  253 days 	Tags: NonMagic,Part,Safe
Item Number 55              Name: Thin chisel with ornamental grip                    Age:  293 years,  104 days 	Tags: NonMagic,Part,Safe,Tool
Item Number 56              Name: Glass bottle with layered colored sand              Age:  109 years,   95 days 	Tags: NonMagic,RawMaterial,Safe,Trinket
Item Number 57              Name: Card with pressed flower sealed in wax              Age:  156 years,  107 days 	Tags: NonMagic,Safe,Trinket
Item Number 58              Name: Wooden peg painted like a tiny soldier              Age:  140 years,  118 days 	Tags: NonMagic,Safe,Trinket
Item Number 59              Name: Bundle of dyed feathers                             Age:  435 years,  131 days 	Tags: NonMagic,Safe,Trinket
Item Number 60              Name: Compass needle in a wax paper packet                Age:  117 years,  236 days 	Tags: NonMagic,Part,Safe
Item Number 61              Name: Small tin marked “springs & things”                 Age:  414 years,  220 days 	Tags: NonMagic,Part,Safe,Tool
Item Number 62              Name: Wire loop with unknown purpose                      Age:  293 years,  289 days 	Tags: NonMagic,Part,Safe
Item Number 63              Name: Empty brass cartridge casing                        Age:   53 years,  241 days 	Tags: NonMagic,Part,Safe
Item Number 64              Name: Block of scented soap (cedar)                       Age:   68 years,  322 days 	Tags: FOOD,NonMagic,Safe
Item Number 65              Name: Cracked magnifying lens                             Age:  129 years,  311 days 	Tags: Device,NonMagic,Safe
Item Number 66              Name: Matchbox full of carved wooden stars                Age:  322 years,  110 days 	Tags: NonMagic,Safe,Trinket
Item Number 67              Name: Tiny hourglass (sand has settled)                   Age:  341 years,  147 days 	Tags: NonMagic,Safe,Trinket
Item Number 68              Name: Strip of linen printed with equations               Age:  430 years,   59 days 	Tags: NonMagic,RawMaterial,Safe
Item Number 69              Name: Shard of mirror painted with sigils                 Age:  220 years,   59 days 	Tags: Magic,Safe,Trinket
Item Number 70              Name: Leather-bound scrap of blueprint                    Age:   48 years,  241 days 	Tags: NonMagic,Safe,Trinket
Item Number 71              Name: Personal trinket: Thread-tied toothpick carvings    Age:  369 years,   80 days 	Tags: Important,Remembered,Trinket
Item Number 72              Name: Thread-wrapped magnet                               Age:   19 years,   62 days 	Tags: NonMagic,Part,Safe
Item Number 73              Name: Vial of glittering mineral dust                     Age:  475 years,    2 days 	Tags: AlchemySupply,NonMagic,RawMaterial,Safe
Item Number 74              Name: Bone needle (smooth and old)                        Age:  489 years,  241 days 	Tags: NonMagic,Safe,Tool
Item Number 75              Name: Miniature harmonica (1 note stuck)                  Age:  360 years,  216 days 	Tags: Device,NonMagic,Safe
Item Number 76              Name: Brass buckle with stylized sun                      Age:  380 years,  361 days 	Tags: Clothing,NonMagic,Safe,Trinket
Item Number 77              Name: Coin from a country that doesn’t exist              Age:   11 years,  348 days 	Tags: Currency,NonMagic,Safe,Trinket
Item Number 78              Name: Bundle of cloth strips (various colors)             Age:  135 years,  161 days 	Tags: Clothing,NonMagic,Safe
Item Number 79              Name: Scorched scrap of parchment                         Age:  213 years,   40 days 	Tags: Dangerous,NonMagic,Trinket
Item Number 80              Name: Unfired clay bead                                   Age:  436 years,  356 days 	Tags: NonMagic,RawMaterial,Safe
Item Number 81              Name: Segment of coiled spring steel                      Age:   54 years,  274 days 	Tags: NonMagic,Part,Safe
Item Number 82              Name: Folded letter in indecipherable script              Age:  371 years,  272 days 	Tags: NonMagic,Safe,Trinket
Item Number 83              Name: Wax-sealed bottle with mystery liquid               Age:  412 years,  235 days 	Tags: AlchemySupply,Magic,Safe
Item Number 84              Name: Tiny spool of copper braid                          Age:  127 years,  138 days 	Tags: NonMagic,Part,Safe
Item Number 85              Name: Burnt match with a rune on it                       Age:  434 years,  191 days 	Tags: Dangerous,Magic,Safe
Item Number 86              Name: Hexagonal nut (too small for anything)              Age:   28 years,  111 days 	Tags: NonMagic,Part,Safe
Item Number 87              Name: Small corked jar of red sand                        Age:  279 years,  170 days 	Tags: AlchemySupply,NonMagic,RawMaterial,Safe
Item Number 88              Name: Fish scale laminated in glass                       Age:  445 years,   61 days 	Tags: AlchemySupply,NonMagic,RawMaterial,Safe
Item Number 89              Name: Pebble that hums when warm                          Age:  263 years,   36 days 	Tags: Magic,Safe,Trinket
Item Number 90              Name: Pocket sewing kit (missing needle)                  Age:  461 years,  213 days 	Tags: Clothing,NonMagic,Safe,Tool
Item Number 91              Name: Miniature trowel (flat edge worn)                   Age:  347 years,   20 days 	Tags: NonMagic,Safe,Tool
Item Number 92              Name: Tattered cloth bookmark with initials               Age:  196 years,   92 days 	Tags: Clothing,NonMagic,Safe,Trinket
Item Number 93              Name: Wedge of polished bone (non-magical)                Age:   77 years,   11 days 	Tags: NonMagic,Safe,Trinket
Item Number 94              Name: Dried leaf laminated between clear wax              Age:  402 years,  352 days 	Tags: FOOD,NonMagic,Safe
Item Number 95              Name: Copper pipe elbow (unfitted)                        Age:  363 years,   10 days 	Tags: NonMagic,Part,Safe
Item Number 96              Name: Smoothed stick of charcoal                          Age:  170 years,  183 days 	Tags: NonMagic,RawMaterial,Safe
Item Number 97              Name: Soft leather pouch, empty                           Age:   27 years,  168 days 	Tags: Clothing,NonMagic,Safe,Trinket
Item Number 98              Name: Folded metal clasp (bent)                           Age:  484 years,  240 days 	Tags: NonMagic,Part,Safe
Item Number 99              Name: Wire mesh square (2x2 inches)                       Age:  211 years,  334 days 	Tags: NonMagic,Part,Safe
Item Number 100             Name: Stone tile fragment with inlaid spiral              Age:  416 years,  155 days 	Tags: NonMagic,Safe,Trinket
Item Number 101             Name: Threaded brass fitting                              Age:   13 years,   92 days 	Tags: NonMagic,Part,Safe,TinkeringGear,Tool
Item Number 102             Name: Steel bolt with hex head                            Age:   43 years,   25 days 	Tags: NonMagic,Part,Safe,TinkeringGear,Tool
Item Number 103             Name: Copper gear with 24 teeth                           Age:    8 years,  220 days 	Tags: NonMagic,Part,Safe,TinkeringGear,Tool
Item Number 104             Name: Miniature iron pulley                               Age:  474 years,   10 days 	Tags: NonMagic,Part,Safe,TinkeringGear,Tool
Item Number 105             Name: Cast iron bracket                                   Age:   21 years,  359 days 	Tags: NonMagic,Part,Safe,TinkeringGear,Tool
Item Number 106             Name: Set of brass spacers                                Age:    0 years,  186 days 	Tags: NonMagic,Part,Recent,Remembered,Safe,TinkeringGear,Tool
Item Number 107             Name: Polished steel washer                               Age:    0 years,    3 days 	Tags: NonMagic,Part,Recent,Remembered,Safe,TinkeringGear,Tool
Item Number 108             Name: Flathead adjustment screw                           Age:   61 years,   26 days 	Tags: NonMagic,Part,Safe,TinkeringGear,Tool
Item Number 109             Name: Machined steel armature                             Age:  398 years,  358 days 	Tags: NonMagic,Part,Safe,TinkeringGear,Tool
Item Number 110             Name: Segment of copper tubing                            Age:   13 years,  147 days 	Tags: NonMagic,Part,Safe,TinkeringGear,Tool
Item Number 111             Name: Miniature brass vise                                Age:    0 years,   12 days 	Tags: NonMagic,Part,Recent,Remembered,Safe,TinkeringGear,Tool
Item Number 112             Name: Steel spring (3 turns)                              Age:  231 years,  364 days 	Tags: NonMagic,Part,Safe,TinkeringGear,Tool
Item Number 113             Name: Box of mixed fasteners                              Age:  312 years,   25 days 	Tags: NonMagic,Part,Safe,TinkeringGear,Tool
Item Number 114             Name: Slotted steel plate                                 Age:    0 years,  100 days 	Tags: NonMagic,Part,Safe,TinkeringGear,Tool
Item Number 115             Name: Aluminum clamp ring                                 Age:  488 years,  201 days 	Tags: NonMagic,Part,Safe,TinkeringGear,Tool
Item Number 116             Name: Segment of toothed belt                             Age:   38 years,  161 days 	Tags: NonMagic,Part,Safe,TinkeringGear,Tool
Item Number 117             Name: Machined brass hinge                                Age:  134 years,  331 days 	Tags: NonMagic,Part,Safe,TinkeringGear,Tool
Item Number 118             Name: Fine adjustment knob (steel)                        Age:  397 years,  180 days 	Tags: NonMagic,Part,Safe,TinkeringGear,Tool
Item Number 119             Name: Iron flange with bolt holes                         Age:  172 years,  233 days 	Tags: NonMagic,Part,Safe,TinkeringGear,Tool
Item Number 120             Name: Small caliper (brass jaws)                          Age:    0 years,  181 days 	Tags: NonMagic,Part,Recent,Remembered,Safe,TinkeringGear,Tool
Item Number 121             Name: Threaded steel rod                                  Age:  350 years,  114 days 	Tags: NonMagic,Part,Safe,TinkeringGear,Tool
Item Number 122             Name: Steel locking collar                                Age:   72 years,  249 days 	Tags: NonMagic,Part,Safe,TinkeringGear,Tool
Item Number 123             Name: Set of iron cotter pins                             Age:    0 years,   78 days 	Tags: NonMagic,Part,Recent,Remembered,Safe,TinkeringGear,Tool
Item Number 124             Name: Adjustable tension bolt                             Age:    9 years,  137 days 	Tags: NonMagic,Part,Safe,TinkeringGear,Tool
Item Number 125             Name: Brass hex coupling                                  Age:  418 years,  200 days 	Tags: NonMagic,Part,Safe,TinkeringGear,Tool
Item Number 126             Name: Steel rail stop                                     Age:  103 years,   28 days 	Tags: NonMagic,Part,Safe,TinkeringGear,Tool
Item Number 127             Name: Fitted bearing cap                                  Age:    0 years,    4 days 	Tags: NonMagic,Part,Recent,Remembered,Safe,TinkeringGear,Tool
Item Number 128             Name: Rotary axle joint                                   Age:  395 years,   64 days 	Tags: NonMagic,Part,Safe,TinkeringGear,Tool
Item Number 129             Name: Notched alignment tab                               Age:    0 years,  136 days 	Tags: Important,NonMagic,Part,Remembered,Safe,TinkeringGear,Tool
Item Number 130             Name: Brass split washer                                  Age:   20 years,  212 days 	Tags: NonMagic,Part,Safe,TinkeringGear,Tool
Item Number 131             Name: Iron shim plate                                     Age:  156 years,  324 days 	Tags: NonMagic,Part,Safe,TinkeringGear,Tool
Item Number 132             Name: Small crank handle                                  Age:   56 years,  205 days 	Tags: NonMagic,Part,Safe,TinkeringGear,Tool
Item Number 133             Name: Compression ring (steel)                            Age:  413 years,  195 days 	Tags: NonMagic,Part,Safe,TinkeringGear,Tool
Item Number 134             Name: Brass retaining clip                                Age:    0 years,   84 days 	Tags: NonMagic,Part,Recent,Remembered,Safe,TinkeringGear,Tool
Item Number 135             Name: Steel locking nut                                   Age:  147 years,  345 days 	Tags: NonMagic,Part,Safe,TinkeringGear,Tool
Item Number 136             Name: Set of small bushings                               Age:    0 years,    1 days 	Tags: NonMagic,Part,Recent,Remembered,Safe,TinkeringGear,Tool
Item Number 137             Name: Gear segment (9 teeth)                              Age:   58 years,  300 days 	Tags: NonMagic,Part,Safe,TinkeringGear,Tool
Item Number 138             Name: Double-threaded screw                               Age:  488 years,  293 days 	Tags: NonMagic,Part,Safe,TinkeringGear,Tool
Item Number 139             Name: Flat steel baffle plate                             Age:   27 years,   44 days 	Tags: NonMagic,Part,Safe,TinkeringGear,Tool
Item Number 140             Name: Iron valve stem                                     Age:  296 years,  115 days 	Tags: NonMagic,Part,Safe,TinkeringGear,Tool
Item Number 141             Name: Crossbar coupler fitting                            Age:    0 years,   58 days 	Tags: NonMagic,Part,Recent,Remembered,Safe,TinkeringGear,Tool
Item Number 142             Name: Slotted rotary shaft                                Age:   79 years,  318 days 	Tags: NonMagic,Part,Safe,TinkeringGear,Tool
Item Number 143             Name: Small tensioning wheel                              Age:   34 years,  314 days 	Tags: NonMagic,Part,Safe,TinkeringGear,Tool
Item Number 144             Name: Knurled grip sleeve                                 Age:  109 years,   21 days 	Tags: NonMagic,Part,Safe,TinkeringGear,Tool
Item Number 145             Name: Anchor bolt with washer                             Age:    1 years,   37 days 	Tags: NonMagic,Part,Safe,TinkeringGear,Tool
Item Number 146             Name: Segment of copper winding                           Age:   41 years,  136 days 	Tags: NonMagic,Part,Safe,TinkeringGear,Tool
Item Number 147             Name: Fixed position dial stop                            Age:   33 years,   41 days 	Tags: NonMagic,Part,Safe,TinkeringGear,Tool
Item Number 148             Name: Cast iron sprocket                                  Age:  327 years,   36 days 	Tags: NonMagic,Part,Safe,TinkeringGear,Tool
Item Number 149             Name: Brass sleeve bearing                                Age:    2 years,  256 days 	Tags: Important,NonMagic,Part,Remembered,Safe,TinkeringGear,Tool
Item Number 150             Name: Lock-ring with threaded edge                        Age:    6 years,  354 days 	Tags: NonMagic,Part,Safe,TinkeringGear,Tool
Item Number 151             Name: Flanged steel wheel                                 Age:  305 years,  175 days 	Tags: NonMagic,Part,Safe,TinkeringGear,Tool
Item Number 152             Name: Steel spring pin                                    Age:    0 years,   20 days 	Tags: NonMagic,Part,Recent,Remembered,Safe,TinkeringGear,Tool
Item Number 153             Name: Split copper terminal                               Age:  189 years,   15 days 	Tags: NonMagic,Part,Safe,TinkeringGear,Tool
Item Number 154             Name: Slotted crank pin                                   Age:  408 years,  354 days 	Tags: NonMagic,Part,Safe,TinkeringGear,Tool
Item Number 155             Name: Threaded coupling nut                               Age:  356 years,   98 days 	Tags: NonMagic,Part,Safe,TinkeringGear,Tool
Item Number 156             Name: Miniature tension ring                              Age:    0 years,  133 days 	Tags: Important,NonMagic,Part,Remembered,Safe,TinkeringGear,Tool
Item Number 157             Name: Bolt-action cam lever                               Age:    0 years,  150 days 	Tags: NonMagic,Part,Safe,TinkeringGear,Tool
Item Number 158             Name: Steel ball bearing (8 mm)                           Age:   37 years,  265 days 	Tags: NonMagic,Part,Safe,TinkeringGear,Tool
Item Number 159             Name: Washer stack (mixed)                                Age:   94 years,  172 days 	Tags: NonMagic,Part,Safe,TinkeringGear,Tool
Item Number 160             Name: Tapped anchor plate                                 Age:    2 years,   31 days 	Tags: NonMagic,Part,Recent,Remembered,Safe,TinkeringGear,Tool
Item Number 161             Name: Bearing shell, brass                                Age:   25 years,   63 days 	Tags: NonMagic,Part,Safe,TinkeringGear,Tool
Item Number 162             Name: Machined guide rail                                 Age:  493 years,  349 days 	Tags: NonMagic,Part,Safe,TinkeringGear,Tool
Item Number 163             Name: Segment of worm gear                                Age:   78 years,   41 days 	Tags: NonMagic,Part,Safe,TinkeringGear,Tool
Item Number 164             Name: Iron U-bracket                                      Age:  335 years,    9 days 	Tags: NonMagic,Part,Safe,TinkeringGear,Tool
Item Number 165             Name: Precision guide pin                                 Age:  149 years,  294 days 	Tags: NonMagic,Part,Safe,TinkeringGear,Tool
Item Number 166             Name: Set of brass pins                                   Age:   26 years,  340 days 	Tags: NonMagic,Part,Safe,TinkeringGear,Tool
Item Number 167             Name: Slotted mounting tab                                Age:  355 years,  260 days 	Tags: NonMagic,Part,Safe,TinkeringGear,Tool
Item Number 168             Name: Roller wheel with axle                              Age:    1 years,  149 days 	Tags: Important,NonMagic,Part,Remembered,Safe,TinkeringGear,Tool
Item Number 169             Name: Finned brass heatsink                               Age:    4 years,   64 days 	Tags: NonMagic,Part,Safe,TinkeringGear,Tool
Item Number 170             Name: Steel cotter sleeve                                 Age:   89 years,  232 days 	Tags: NonMagic,Part,Safe,TinkeringGear,Tool
Item Number 171             Name: Quick-release locking pin                           Age:    0 years,   19 days 	Tags: NonMagic,Part,Recent,Remembered,Safe,TinkeringGear,Tool
Item Number 172             Name: Segment of braided wire                             Age:  211 years,  348 days 	Tags: NonMagic,Part,Safe,TinkeringGear,Tool
Item Number 173             Name: Insulated connector block                           Age:   29 years,  172 days 	Tags: NonMagic,Part,Safe,TinkeringGear,Tool
Item Number 174             Name: Copper tie rod                                      Age:  427 years,  199 days 	Tags: NonMagic,Part,Safe,TinkeringGear,Tool
Item Number 175             Name: Small knurled set screw                             Age:    7 years,  316 days 	Tags: NonMagic,Part,Safe,TinkeringGear,Tool
Item Number 176             Name: Machined toggle clamp                               Age:  269 years,  335 days 	Tags: NonMagic,Part,Safe,TinkeringGear,Tool
Item Number 177             Name: Steel indexing plate                                Age:   51 years,   25 days 	Tags: NonMagic,Part,Safe,TinkeringGear,Tool
Item Number 178             Name: Welded brace (2-inch)                               Age:  212 years,  361 days 	Tags: NonMagic,Part,Safe,TinkeringGear,Tool
Item Number 179             Name: Cast iron elbow                                     Age:   98 years,  342 days 	Tags: NonMagic,Part,Safe,TinkeringGear,Tool
Item Number 180             Name: Polished steel disk                                 Age:    0 years,   40 days 	Tags: NonMagic,Part,Safe,TinkeringGear,Tool
Item Number 181             Name: Friction cap (rubber edge)                          Age:  422 years,  357 days 	Tags: NonMagic,Part,Safe,TinkeringGear,Tool
Item Number 182             Name: Coupling ring with teeth                            Age:   36 years,  362 days 	Tags: NonMagic,Part,Safe,TinkeringGear,Tool
Item Number 183             Name: Steel crossbeam stub                                Age:  284 years,  332 days 	Tags: NonMagic,Part,Safe,TinkeringGear,Tool
Item Number 184             Name: Flat-faced hinge plate                              Age:  156 years,   98 days 	Tags: NonMagic,Part,Safe,TinkeringGear,Tool
Item Number 185             Name: Threaded alignment peg                              Age:    0 years,  125 days 	Tags: NonMagic,Part,Safe,TinkeringGear,Tool
Item Number 186             Name: Split shaft collar                                  Age:  485 years,  196 days 	Tags: NonMagic,Part,Safe,TinkeringGear,Tool
Item Number 187             Name: Guide bushing (press-fit)                           Age:    4 years,   30 days 	Tags: NonMagic,Part,Safe,TinkeringGear,Tool
Item Number 188             Name: Iron positioning washer                             Age:  493 years,  240 days 	Tags: NonMagic,Part,Safe,TinkeringGear,Tool
Item Number 189             Name: Steel faceplate ring                                Age:   10 years,  329 days 	Tags: NonMagic,Part,Safe,TinkeringGear,Tool
Item Number 190             Name: Miniature bearing retainer                          Age:  192 years,  165 days 	Tags: NonMagic,Part,Safe,TinkeringGear,Tool
Item Number 191             Name: Offset arm lever                                    Age:    3 years,  144 days 	Tags: NonMagic,Part,Safe,TinkeringGear,Tool
Item Number 192             Name: Steel hanger bracket                                Age:   75 years,  305 days 	Tags: NonMagic,Part,Safe,TinkeringGear,Tool
Item Number 193             Name: Slotted indexing ring                               Age:  393 years,  252 days 	Tags: NonMagic,Part,Safe,TinkeringGear,Tool
Item Number 194             Name: Copper contact pad                                  Age:    9 years,  298 days 	Tags: NonMagic,Part,Safe,TinkeringGear,Tool
Item Number 195             Name: Notched slider plate                                Age:  199 years,  310 days 	Tags: NonMagic,Part,Safe,TinkeringGear,Tool
Item Number 196             Name: Shouldered anchor pin                               Age:    0 years,    6 days 	Tags: NonMagic,Part,Recent,Remembered,Safe,TinkeringGear,Tool
Item Number 197             Name: Friction tension washer                             Age:  113 years,  128 days 	Tags: NonMagic,Part,Safe,TinkeringGear,Tool
Item Number 198             Name: Set of three axle pins                              Age:  142 years,  293 days 	Tags: NonMagic,Part,Safe,TinkeringGear,Tool
Item Number 199             Name: Threaded flange collar                              Age:    5 years,   11 days 	Tags: NonMagic,Part,Safe,TinkeringGear,Tool
Item Number 200             Name: Brass gear segment (12° arc)                        Age:   87 years,  237 days 	Tags: NonMagic,Part,Safe,TinkeringGear,Tool
Item Number 201             Name: Vial of red sand                                    Age:  365 years,  232 days 	Tags: Alchemical,AlchemySupply,AlchemySupplySet,Dangerous,RawMaterial
Item Number 202             Name: Sealed flask containing quicklime                   Age:  473 years,  276 days 	Tags: Alchemical,AlchemySupply,AlchemySupplySet,Dangerous,RawMaterial
Item Number 203             Name: Packet of alchemical chalk                          Age:    0 years,    6 days 	Tags: Alchemical,AlchemySupply,AlchemySupplySet,RawMaterial,Recent,Remembered,Safe
Item Number 204             Name: Mortar-stained copper spoon                         Age:   24 years,   33 days 	Tags: Alchemical,AlchemySupply,AlchemySupplySet,RawMaterial,Safe
Item Number 205             Name: Bundle of dried lavender                            Age:  302 years,  161 days 	Tags: Alchemical,AlchemySupply,AlchemySupplySet,RawMaterial,Safe
Item Number 206             Name: Stoppered jar of ether oil                          Age:   45 years,  213 days 	Tags: Alchemical,AlchemySupply,AlchemySupplySet,Dangerous,RawMaterial
Item Number 207             Name: Vial of glow paste                                  Age:  336 years,  183 days 	Tags: Alchemical,AlchemySupply,AlchemySupplySet,RawMaterial,Safe
Item Number 208             Name: Flask of moonwater                                  Age:  494 years,   29 days 	Tags: Alchemical,AlchemySupply,AlchemySupplySet,RawMaterial,Safe
Item Number 209             Name: Sealed jar of crushed bone                          Age:  214 years,  185 days 	Tags: Alchemical,AlchemySupply,AlchemySupplySet,Dangerous,RawMaterial
Item Number 210             Name: Dusted glass vial (empty)                           Age:   89 years,  306 days 	Tags: Alchemical,AlchemySupply,AlchemySupplySet,RawMaterial,Safe
Item Number 211             Name: Folded packet of ash flakes                         Age:  132 years,  144 days 	Tags: Alchemical,AlchemySupply,AlchemySupplySet,RawMaterial,Safe
Item Number 212             Name: Labeled flask: aether sediment                      Age:  388 years,  119 days 	Tags: Alchemical,AlchemySupply,AlchemySupplySet,RawMaterial,Safe
Item Number 213             Name: Pouch of iron filings                               Age:  440 years,  346 days 	Tags: Alchemical,AlchemySupply,AlchemySupplySet,Dangerous,RawMaterial
Item Number 214             Name: Cork-stoppered vial (red residue)                   Age:  310 years,   44 days 	Tags: Alchemical,AlchemySupply,AlchemySupplySet,Dangerous,RawMaterial
Item Number 215             Name: Bundle of dried duskmint                            Age:  382 years,  137 days 	Tags: Alchemical,AlchemySupply,AlchemySupplySet,RawMaterial,Safe
Item Number 216             Name: Wide-mouthed clay jar                               Age:    2 years,  310 days 	Tags: Alchemical,AlchemySupply,AlchemySupplySet,RawMaterial,Recent,Remembered,Safe
Item Number 217             Name: Mortar with herb residue                            Age:   12 years,  187 days 	Tags: Alchemical,AlchemySupply,AlchemySupplySet,RawMaterial,Safe
Item Number 218             Name: Labeled sachet of wormroot                          Age:    0 years,  127 days 	Tags: Alchemical,AlchemySupply,AlchemySupplySet,Important,RawMaterial,Remembered,Safe
Item Number 219             Name: Vial of quicksilver suspension                      Age:  340 years,   70 days 	Tags: Alchemical,AlchemySupply,AlchemySupplySet,Dangerous,RawMaterial
Item Number 220             Name: Glass dropper bottle (half-full)                    Age:    0 years,  103 days 	Tags: Alchemical,AlchemySupply,AlchemySupplySet,RawMaterial,Recent,Remembered,Safe
Item Number 221             Name: Packet of powdered brimstone                        Age:  260 years,  187 days 	Tags: Alchemical,AlchemySupply,AlchemySupplySet,Dangerous,RawMaterial
Item Number 222             Name: Waxed paper pouch: glow spores                      Age:  490 years,  261 days 	Tags: Alchemical,AlchemySupply,AlchemySupplySet,Dangerous,RawMaterial
Item Number 223             Name: Twisted vial of volatile salt                       Age:   48 years,   81 days 	Tags: Alchemical,AlchemySupply,AlchemySupplySet,Dangerous,RawMaterial
Item Number 224             Name: Spoon stained with purple tincture                  Age:   29 years,  338 days 	Tags: Alchemical,AlchemySupply,AlchemySupplySet,RawMaterial,Safe
Item Number 225             Name: Metal canister of sediment extract                  Age:    3 years,  254 days 	Tags: Alchemical,AlchemySupply,AlchemySupplySet,RawMaterial,Safe
Item Number 226             Name: Stoppered vial with brown scum                      Age:   13 years,   77 days 	Tags: Alchemical,AlchemySupply,AlchemySupplySet,Dangerous,RawMaterial
Item Number 227             Name: Linen-wrapped bundle of dried herbs                 Age:  499 years,   69 days 	Tags: Alchemical,AlchemySupply,AlchemySupplySet,RawMaterial,Safe
Item Number 228             Name: Crystal phial: lunar dust                           Age:    0 years,  119 days 	Tags: Alchemical,AlchemySupply,AlchemySupplySet,RawMaterial,Recent,Remembered,Safe
Item Number 229             Name: Folded leaf packet: duskmint shavings               Age:    0 years,   56 days 	Tags: Alchemical,AlchemySupply,AlchemySupplySet,RawMaterial,Recent,Remembered,Safe
Item Number 230             Name: Alum-crusted stirring rod                           Age:  253 years,   62 days 	Tags: Alchemical,AlchemySupply,AlchemySupplySet,RawMaterial,Safe
Item Number 231             Name: Black-glass vial (opaque)                           Age:  311 years,   35 days 	Tags: Alchemical,AlchemySupply,AlchemySupplySet,Dangerous,RawMaterial
Item Number 232             Name: Thin glass pipette (intact)                         Age:    0 years,   40 days 	Tags: Alchemical,AlchemySupply,AlchemySupplySet,RawMaterial,Recent,Remembered,Safe
Item Number 233             Name: Sachet marked “arcane ash”                          Age:  134 years,  213 days 	Tags: Alchemical,AlchemySupply,AlchemySupplySet,RawMaterial,Safe
Item Number 234             Name: Vial: silver-tinged water                           Age:   25 years,  249 days 	Tags: Alchemical,AlchemySupply,AlchemySupplySet,RawMaterial,Safe
Item Number 235             Name: Herbal extract in corked tube                       Age:    0 years,  252 days 	Tags: Alchemical,AlchemySupply,AlchemySupplySet,Important,RawMaterial,Remembered,Safe
Item Number 236             Name: Bottle marked: aether base                          Age:  421 years,  243 days 	Tags: Alchemical,AlchemySupply,AlchemySupplySet,RawMaterial,Safe
Item Number 237             Name: Wax-lined herb packet (cracked)                     Age:    0 years,  180 days 	Tags: Alchemical,AlchemySupply,AlchemySupplySet,RawMaterial,Recent,Remembered,Safe
Item Number 238             Name: Flask of powdered coal dust                         Age:  102 years,  189 days 	Tags: Alchemical,AlchemySupply,AlchemySupplySet,Dangerous,RawMaterial
Item Number 239             Name: Stoppered green flask (viscous)                     Age:   18 years,  152 days 	Tags: Alchemical,AlchemySupply,AlchemySupplySet,Dangerous,RawMaterial
Item Number 240             Name: Jar containing dried moss clumps                    Age:   66 years,  215 days 	Tags: Alchemical,AlchemySupply,AlchemySupplySet,RawMaterial,Safe
Item Number 241             Name: Copper stirring spoon                               Age:   37 years,  318 days 	Tags: Alchemical,AlchemySupply,AlchemySupplySet,RawMaterial,Safe
Item Number 242             Name: Soft clay container (char-stained)                  Age:    0 years,   69 days 	Tags: Alchemical,AlchemySupply,AlchemySupplySet,RawMaterial,Recent,Remembered,Safe
Item Number 243             Name: Blackroot paste in sealed pot                       Age:   23 years,  114 days 	Tags: Alchemical,AlchemySupply,AlchemySupplySet,Dangerous,RawMaterial
Item Number 244             Name: Clear vial: glowing sediment                        Age:  493 years,  339 days 	Tags: Alchemical,AlchemySupply,AlchemySupplySet,RawMaterial,Safe
Item Number 245             Name: Bundle of flattened herb stalks                     Age:  429 years,  286 days 	Tags: Alchemical,AlchemySupply,AlchemySupplySet,RawMaterial,Safe
Item Number 246             Name: Aluminum funnel (small)                             Age:    0 years,    2 days 	Tags: Alchemical,AlchemySupply,AlchemySupplySet,RawMaterial,Recent,Remembered,Safe
Item Number 247             Name: Stoppered jar: silty residue                        Age:  399 years,  241 days 	Tags: Alchemical,AlchemySupply,AlchemySupplySet,Dangerous,RawMaterial
Item Number 248             Name: Crystal bottle labeled “Nightglass”                 Age:  251 years,  249 days 	Tags: Alchemical,AlchemySupply,AlchemySupplySet,RawMaterial,Safe
Item Number 249             Name: Sealed tin of aether clay                           Age:  212 years,   32 days 	Tags: Alchemical,AlchemySupply,AlchemySupplySet,Dangerous,RawMaterial
Item Number 250             Name: Metal tongs (singe marks)                           Age:    0 years,  176 days 	Tags: Alchemical,AlchemySupply,AlchemySupplySet,RawMaterial,Safe
Item Number 251             Name: Dry pouch of forest soot                            Age:  228 years,  154 days 	Tags: Alchemical,AlchemySupply,AlchemySupplySet,RawMaterial,Safe
Item Number 252             Name: Folded leaf: pressed arcane herbs                   Age:    1 years,  115 days 	Tags: Alchemical,AlchemySupply,AlchemySupplySet,RawMaterial,Safe
Item Number 253             Name: Corked vial: granular substance                     Age:  298 years,  224 days 	Tags: Alchemical,AlchemySupply,AlchemySupplySet,RawMaterial,Safe
Item Number 254             Name: Small flask marked “unstable”                       Age:  239 years,  338 days 	Tags: Alchemical,AlchemySupply,AlchemySupplySet,Dangerous,RawMaterial
Item Number 255             Name: Iron-bound jar (warm to touch)                      Age:    3 years,  145 days 	Tags: Alchemical,AlchemySupply,AlchemySupplySet,Dangerous,RawMaterial
Item Number 256             Name: Pouch of crystallized sap                           Age:  495 years,  174 days 	Tags: Alchemical,AlchemySupply,AlchemySupplySet,RawMaterial,Safe
Item Number 257             Name: Steel stirring wand                                 Age:   51 years,  206 days 	Tags: Alchemical,AlchemySupply,AlchemySupplySet,RawMaterial,Safe
Item Number 258             Name: Vial of milky fluid (unlabeled)                     Age:   16 years,   65 days 	Tags: Alchemical,AlchemySupply,AlchemySupplySet,RawMaterial,Safe
Item Number 259             Name: Cloth-wrapped extract bottle                        Age:    0 years,    4 days 	Tags: Alchemical,AlchemySupply,AlchemySupplySet,RawMaterial,Recent,Remembered,Safe
Item Number 260             Name: Jar of soft resin (sticky)                          Age:    2 years,  343 days 	Tags: Alchemical,AlchemySupply,AlchemySupplySet,RawMaterial,Safe
Item Number 261             Name: Folded parchment: reagent notes                     Age:  363 years,   98 days 	Tags: Alchemical,AlchemySupply,AlchemySupplySet,RawMaterial,Safe
Item Number 262             Name: Blue wax packet: scented extract                    Age:  403 years,  199 days 	Tags: Alchemical,AlchemySupply,AlchemySupplySet,RawMaterial,Safe
Item Number 263             Name: Glass bottle: inert powder                          Age:    0 years,   12 days 	Tags: Alchemical,AlchemySupply,AlchemySupplySet,RawMaterial,Recent,Remembered,Safe
Item Number 264             Name: Pouch of powdered chalk mix                         Age:    5 years,  168 days 	Tags: Alchemical,AlchemySupply,AlchemySupplySet,RawMaterial,Safe
Item Number 265             Name: Charcoal-streaked stirring rod                      Age:    0 years,  142 days 	Tags: Alchemical,AlchemySupply,AlchemySupplySet,RawMaterial,Safe
Item Number 266             Name: Thin metal bowl (stained)                           Age:  266 years,  330 days 	Tags: Alchemical,AlchemySupply,AlchemySupplySet,RawMaterial,Safe
Item Number 267             Name: Pressed flower bundle (dried)                       Age:   64 years,  287 days 	Tags: Alchemical,AlchemySupply,AlchemySupplySet,RawMaterial,Safe
Item Number 268             Name: Vial of unstable ether salt                         Age:   30 years,  299 days 	Tags: Alchemical,AlchemySupply,AlchemySupplySet,Dangerous,RawMaterial
Item Number 269             Name: Wax-stoppered flask: ash slurry                     Age:  488 years,   52 days 	Tags: Alchemical,AlchemySupply,AlchemySupplySet,Dangerous,RawMaterial
Item Number 270             Name: Metal spoon (distilled residue)                     Age:  456 years,   67 days 	Tags: Alchemical,AlchemySupply,AlchemySupplySet,RawMaterial,Safe
Item Number 271             Name: Glass tube of fine green powder                     Age:    0 years,  120 days 	Tags: Alchemical,AlchemySupply,AlchemySupplySet,RawMaterial,Safe
Item Number 272             Name: Labeled cork packet: bloodroot                      Age:    0 years,   87 days 	Tags: Alchemical,AlchemySupply,AlchemySupplySet,RawMaterial,Recent,Remembered,Safe
Item Number 273             Name: Small phial of binding gel                          Age:    0 years,  122 days 	Tags: Alchemical,AlchemySupply,AlchemySupplySet,Important,RawMaterial,Remembered,Safe
Item Number 274             Name: Dusty bottle: unknown extract                       Age:   62 years,  189 days 	Tags: Alchemical,AlchemySupply,AlchemySupplySet,Dangerous,RawMaterial
Item Number 275             Name: Sachet labeled “burning sand”                       Age:  305 years,   64 days 	Tags: Alchemical,AlchemySupply,AlchemySupplySet,Dangerous,RawMaterial
Item Number 276             Name: Round vial of beige silt                            Age:    2 years,    1 days 	Tags: Alchemical,AlchemySupply,AlchemySupplySet,RawMaterial,Safe
Item Number 277             Name: Soft pouch of dried root chips                      Age:    4 years,   22 days 	Tags: Alchemical,AlchemySupply,AlchemySupplySet,RawMaterial,Safe
Item Number 278             Name: Alum-lined stone bowl                               Age:   45 years,  325 days 	Tags: Alchemical,AlchemySupply,AlchemySupplySet,RawMaterial,Safe
Item Number 279             Name: Slender phial: bubbling green fluid                 Age:  110 years,  190 days 	Tags: Alchemical,AlchemySupply,AlchemySupplySet,Dangerous,RawMaterial
Item Number 280             Name: Iron flask (corroded exterior)                      Age:   40 years,  141 days 	Tags: Alchemical,AlchemySupply,AlchemySupplySet,Dangerous,RawMaterial
Item Number 281             Name: Corked jar: clear gel (jiggling)                    Age:    0 years,   44 days 	Tags: Alchemical,AlchemySupply,AlchemySupplySet,RawMaterial,Recent,Remembered,Safe
Item Number 282             Name: Powdered compound marked unstable                   Age:   39 years,    3 days 	Tags: Alchemical,AlchemySupply,AlchemySupplySet,Dangerous,RawMaterial
Item Number 283             Name: Vial: rose-colored syrup                            Age:  297 years,  237 days 	Tags: Alchemical,AlchemySupply,AlchemySupplySet,RawMaterial,Safe
Item Number 284             Name: Slotted ladle with char residue                     Age:   95 years,  116 days 	Tags: Alchemical,AlchemySupply,AlchemySupplySet,RawMaterial,Safe
Item Number 285             Name: Pressed root disc in wax paper                      Age:   60 years,  171 days 	Tags: Alchemical,AlchemySupply,AlchemySupplySet,RawMaterial,Safe
Item Number 286             Name: Dropper bottle: blue ink stain                      Age:  383 years,  308 days 	Tags: Alchemical,AlchemySupply,AlchemySupplySet,RawMaterial,Safe
Item Number 287             Name: Char-stained crucible (chipped)                     Age:   39 years,  240 days 	Tags: Alchemical,AlchemySupply,AlchemySupplySet,RawMaterial,Safe
Item Number 288             Name: Blackened bowl with dried resin                     Age:    2 years,  205 days 	Tags: Alchemical,AlchemySupply,AlchemySupplySet,RawMaterial,Safe
Item Number 289             Name: Tightly-sealed vial: volatile                       Age:    0 years,  297 days 	Tags: Alchemical,AlchemySupply,AlchemySupplySet,Dangerous,RawMaterial
Item Number 290             Name: Wrapped bundle: herb-scented rags                   Age:    0 years,  102 days 	Tags: Alchemical,AlchemySupply,AlchemySupplySet,RawMaterial,Recent,Remembered,Safe
Item Number 291             Name: Glass ampoule (sealed tip)                          Age:    4 years,   17 days 	Tags: Alchemical,AlchemySupply,AlchemySupplySet,RawMaterial,Safe
Item Number 292             Name: Extract sample in amber vial                        Age:    0 years,   62 days 	Tags: Alchemical,AlchemySupply,AlchemySupplySet,Important,RawMaterial,Remembered,Safe
Item Number 293             Name: Cracked stirring rod                                Age:  359 years,  115 days 	Tags: Alchemical,AlchemySupply,AlchemySupplySet,RawMaterial,Safe
Item Number 294             Name: Tin of dried nettle leaves                          Age:    0 years,  111 days 	Tags: Alchemical,AlchemySupply,AlchemySupplySet,RawMaterial,Safe
Item Number 295             Name: Unmarked vial (viscous yellow)                      Age:   41 years,  257 days 	Tags: Alchemical,AlchemySupply,AlchemySupplySet,Dangerous,RawMaterial
Item Number 296             Name: Soft-wax tub of herbal paste                        Age:   43 years,  195 days 	Tags: Alchemical,AlchemySupply,AlchemySupplySet,RawMaterial,Safe
Item Number 297             Name: Dusty labeled sachet: sulfur blend                  Age:  335 years,   79 days 	Tags: Alchemical,AlchemySupply,AlchemySupplySet,Dangerous,RawMaterial
Item Number 298             Name: Stoppered jar: swirling particles                   Age:    0 years,   41 days 	Tags: Alchemical,AlchemySupply,AlchemySupplySet,RawMaterial,Safe
Item Number 299             Name: Wide flask: dried sediment layer                    Age:   32 years,  322 days 	Tags: Alchemical,AlchemySupply,AlchemySupplySet,RawMaterial,Safe
Item Number 300             Name: Brass-trimmed bottle (alum crystal)                 Age:    4 years,  222 days 	Tags: Alchemical,AlchemySupply,AlchemySupplySet,RawMaterial,Safe
Item Number 301             Name: Copper button with four holes                       Age:    9 years,  362 days 	Tags: NonMagic,PocketJunk,Safe,Trinket
Item Number 302             Name: Bent iron nail                                      Age:  367 years,  215 days 	Tags: NonMagic,PocketJunk,Safe,Trinket
Item Number 303             Name: Tiny glass marble (clear)                           Age:    0 years,   21 days 	Tags: NonMagic,PocketJunk,Recent,Remembered,Safe,Trinket
Item Number 304             Name: Cracked ceramic token                               Age:   62 years,  281 days 	Tags: NonMagic,PocketJunk,Safe,Trinket
Item Number 305             Name: Loose safety pin (open)                             Age:    3 years,   47 days 	Tags: NonMagic,PocketJunk,Safe,Trinket
Item Number 306             Name: Folded felt scrap (frayed)                          Age:  306 years,  218 days 	Tags: NonMagic,PocketJunk,Safe,Trinket
Item Number 307             Name: Tiny brass hook                                     Age:  518 years,  253 days 	Tags: NonMagic,PocketJunk,Safe,Trinket
Item Number 308             Name: Torn handbill corner                                Age:    2 years,   12 days 	Tags: NonMagic,PocketJunk,Recent,Remembered,Safe,Trinket
Item Number 309             Name: Canvas patch with glue residue                      Age:    3 years,  308 days 	Tags: NonMagic,PocketJunk,Safe,Trinket
Item Number 310             Name: Button with mismatched thread                       Age:    0 years,   31 days 	Tags: NonMagic,PocketJunk,Recent,Remembered,Safe,Trinket
Item Number 311             Name: Key blank (unmarked)                                Age:    0 years,   59 days 	Tags: Important,NonMagic,PocketJunk,Remembered,Safe,Trinket
Item Number 312             Name: Pressed paper chip                                  Age:  490 years,   70 days 	Tags: NonMagic,PocketJunk,Safe,Trinket
Item Number 313             Name: Single shoelace tip (metal)                         Age:   53 years,  127 days 	Tags: NonMagic,PocketJunk,Safe,Trinket
Item Number 314             Name: Paperclip (twisted)                                 Age:   41 years,  343 days 	Tags: NonMagic,PocketJunk,Safe,Trinket
Item Number 315             Name: Stained map fragment                                Age:   24 years,  273 days 	Tags: NonMagic,PocketJunk,Safe,Trinket
Item Number 316             Name: Tiny cork ring                                      Age:    0 years,   46 days 	Tags: NonMagic,PocketJunk,Recent,Remembered,Safe,Trinket
Item Number 317             Name: Old wool button                                     Age:   12 years,  132 days 	Tags: NonMagic,PocketJunk,Safe,Trinket
Item Number 318             Name: Safety pin with bent clasp                          Age:  457 years,  177 days 	Tags: NonMagic,PocketJunk,Safe,Trinket
Item Number 319             Name: Small paper tag (blank)                             Age:    3 years,  239 days 	Tags: NonMagic,PocketJunk,Safe,Trinket
Item Number 320             Name: Broken zipper tooth                                 Age:  413 years,  175 days 	Tags: NonMagic,PocketJunk,Safe,Trinket
Item Number 321             Name: Piece of graphite pencil lead                       Age:    0 years,   63 days 	Tags: NonMagic,PocketJunk,Recent,Remembered,Safe,Trinket
Item Number 322             Name: Crimped bottlecap                                   Age:  324 years,  167 days 	Tags: NonMagic,PocketJunk,Safe,Trinket
Item Number 323             Name: Snapped linen thread piece                          Age:    0 years,    6 days 	Tags: NonMagic,PocketJunk,Recent,Remembered,Safe,Trinket
Item Number 324             Name: Polished button (faded symbol)                      Age:    4 years,  343 days 	Tags: NonMagic,PocketJunk,Safe,Trinket
Item Number 325             Name: Corner of a playing card                            Age:  246 years,  212 days 	Tags: NonMagic,PocketJunk,Safe,Trinket
Item Number 326             Name: Bit of cotton fluff                                 Age:   82 years,   53 days 	Tags: NonMagic,PocketJunk,Safe,Trinket
Item Number 327             Name: Tiny copper bell (no clapper)                       Age:    0 years,  183 days 	Tags: NonMagic,PocketJunk,Safe,Trinket
Item Number 328             Name: Loop of braided thread                              Age:    2 years,  191 days 	Tags: NonMagic,PocketJunk,Safe,Trinket
Item Number 329             Name: Loose marble (chipped)                              Age:    0 years,  132 days 	Tags: NonMagic,PocketJunk,Safe,Trinket
Item Number 330             Name: Ink-stained felt strip                              Age:    0 years,   83 days 	Tags: NonMagic,PocketJunk,Safe,Trinket
Item Number 331             Name: Old wax seal remnant                                Age:  392 years,  211 days 	Tags: NonMagic,PocketJunk,Safe,Trinket
Item Number 332             Name: Shoe eyelet (detached)                              Age:    6 years,   39 days 	Tags: NonMagic,PocketJunk,Safe,Trinket
Item Number 333             Name: Ring box hinge                                      Age:  493 years,  138 days 	Tags: NonMagic,PocketJunk,Safe,Trinket
Item Number 334             Name: Cracked ivory button                                Age:  318 years,  104 days 	Tags: NonMagic,PocketJunk,Safe,Trinket
Item Number 335             Name: Scrap of woven thread                               Age:    2 years,  119 days 	Tags: NonMagic,PocketJunk,Safe,Trinket
Item Number 336             Name: Tiny brass grommet                                  Age:    0 years,   28 days 	Tags: Important,NonMagic,PocketJunk,Remembered,Safe,Trinket
Item Number 337             Name: Bent copper washer                                  Age:  486 years,  355 days 	Tags: NonMagic,PocketJunk,Safe,Trinket
Item Number 338             Name: Broken hook and eye set                             Age:  139 years,  337 days 	Tags: NonMagic,PocketJunk,Safe,Trinket
Item Number 339             Name: Scrap of felt ribbon                                Age:    2 years,   82 days 	Tags: NonMagic,PocketJunk,Safe,Trinket
Item Number 340             Name: Blank coin-shaped disk                              Age:    0 years,  106 days 	Tags: NonMagic,PocketJunk,Recent,Remembered,Safe,Trinket
Item Number 341             Name: Loose thread ball (grey)                            Age:    1 years,   52 days 	Tags: NonMagic,PocketJunk,Safe,Trinket
Item Number 342             Name: Faded handbill stub                                 Age:   53 years,   15 days 	Tags: NonMagic,PocketJunk,Safe,Trinket
Item Number 343             Name: Cork plug with worn edge                            Age:   25 years,  122 days 	Tags: NonMagic,PocketJunk,Safe,Trinket
Item Number 344             Name: Shirt tag fragment (illegible)                      Age:  325 years,  266 days 	Tags: NonMagic,PocketJunk,Safe,Trinket
Item Number 345             Name: Miniature key with broken teeth                     Age:   11 years,   63 days 	Tags: NonMagic,PocketJunk,Safe,Trinket
Item Number 346             Name: Hollow button shell                                 Age:    0 years,   11 days 	Tags: NonMagic,PocketJunk,Recent,Remembered,Safe,Trinket
Item Number 347             Name: Brass ring loop                                     Age:    2 years,   42 days 	Tags: NonMagic,PocketJunk,Safe,Trinket
Item Number 348             Name: Scrap of canvas hem                                 Age:    0 years,  180 days 	Tags: NonMagic,PocketJunk,Safe,Trinket
Item Number 349             Name: Loose pin back                                      Age:  482 years,  357 days 	Tags: NonMagic,PocketJunk,Safe,Trinket
Item Number 350             Name: Sliver of pressed paperboard                        Age:    3 years,  332 days 	Tags: NonMagic,PocketJunk,Safe,Trinket
Item Number 351             Name: Cut buttonhole sample                               Age:  129 years,   16 days 	Tags: NonMagic,PocketJunk,Safe,Trinket
Item Number 352             Name: Threaded cap from ink bottle                        Age:  102 years,   50 days 	Tags: NonMagic,PocketJunk,Safe,Trinket
Item Number 353             Name: Sticker backing fragment                            Age:   49 years,  289 days 	Tags: NonMagic,PocketJunk,Safe,Trinket
Item Number 354             Name: Hook from earring clasp                             Age:   35 years,   37 days 	Tags: NonMagic,PocketJunk,Safe,Trinket
Item Number 355             Name: Bent split ring                                     Age:    5 years,  340 days 	Tags: NonMagic,PocketJunk,Safe,Trinket
Item Number 356             Name: Torn scrap of wrapping paper                        Age:    0 years,  106 days 	Tags: NonMagic,PocketJunk,Safe,Trinket
Item Number 357             Name: Cracked ceramic shard (flat)                        Age:    4 years,   76 days 	Tags: NonMagic,PocketJunk,Safe,Trinket
Item Number 358             Name: Loop of iron wire (tiny)                            Age:    0 years,   55 days 	Tags: NonMagic,PocketJunk,Safe,Trinket
Item Number 359             Name: Stamped metal disk (no markings)                    Age:  355 years,  132 days 	Tags: NonMagic,PocketJunk,Safe,Trinket
Item Number 360             Name: Pinhole punch card chip                             Age:   41 years,  172 days 	Tags: NonMagic,PocketJunk,Safe,Trinket
Item Number 361             Name: Piece of pocket lint                                Age:    0 years,    1 days 	Tags: NonMagic,PocketJunk,Recent,Remembered,Safe,Trinket
Item Number 362             Name: Button with oxidized metal                          Age:  212 years,  132 days 	Tags: NonMagic,PocketJunk,Safe,Trinket
Item Number 363             Name: Tassel fringe segment                               Age:   81 years,  266 days 	Tags: NonMagic,PocketJunk,Safe,Trinket
Item Number 364             Name: Loose string knot (twine)                           Age:   50 years,   66 days 	Tags: NonMagic,PocketJunk,Safe,Trinket
Item Number 365             Name: Half of a shirt tag                                 Age:  282 years,  154 days 	Tags: NonMagic,PocketJunk,Safe,Trinket
Item Number 366             Name: Twisted ring from journal clasp                     Age:    5 years,  329 days 	Tags: NonMagic,PocketJunk,Safe,Trinket
Item Number 367             Name: Woolen fiber tuft                                   Age:   40 years,  162 days 	Tags: NonMagic,PocketJunk,Safe,Trinket
Item Number 368             Name: Scrap of sticker backing                            Age:    0 years,    7 days 	Tags: NonMagic,PocketJunk,Recent,Remembered,Safe,Trinket
Item Number 369             Name: Metal grommet fragment                              Age:   61 years,  269 days 	Tags: NonMagic,PocketJunk,Safe,Trinket
Item Number 370             Name: Plastic rivet base                                  Age:    3 years,  266 days 	Tags: NonMagic,PocketJunk,Safe,Trinket
Item Number 371             Name: Tiny felt flower                                    Age:   33 years,  273 days 	Tags: NonMagic,PocketJunk,Safe,Trinket
Item Number 372             Name: Twist of copper wire                                Age:  181 years,   23 days 	Tags: NonMagic,PocketJunk,Safe,Trinket
Item Number 373             Name: Shiny brass paperclip                               Age:   37 years,  339 days 	Tags: NonMagic,PocketJunk,Safe,Trinket
Item Number 374             Name: Hook from clasp set                                 Age:    0 years,   42 days 	Tags: NonMagic,PocketJunk,Recent,Remembered,Safe,Trinket
Item Number 375             Name: Worn parchment shred                                Age:  494 years,   12 days 	Tags: NonMagic,PocketJunk,Safe,Trinket
Item Number 376             Name: Frayed edge of envelope                             Age:   47 years,  168 days 	Tags: NonMagic,PocketJunk,Safe,Trinket
Item Number 377             Name: Unthreaded needle eye                               Age:    0 years,    4 days 	Tags: NonMagic,PocketJunk,Recent,Remembered,Safe,Trinket
Item Number 378             Name: Piece of cracked buckle                             Age:  406 years,  189 days 	Tags: NonMagic,PocketJunk,Safe,Trinket
Item Number 379             Name: String with knotted beads                           Age:    4 years,   63 days 	Tags: NonMagic,PocketJunk,Safe,Trinket
Item Number 380             Name: Cork disc (cut unevenly)                            Age:    0 years,  115 days 	Tags: NonMagic,PocketJunk,Safe,Trinket
Item Number 381             Name: Split end of paper roll                             Age:   18 years,  332 days 	Tags: NonMagic,PocketJunk,Safe,Trinket
Item Number 382             Name: Detached cloth label                                Age:   73 years,  236 days 	Tags: NonMagic,PocketJunk,Safe,Trinket
Item Number 383             Name: Loop of thread (red)                                Age:  105 years,   93 days 	Tags: NonMagic,PocketJunk,Safe,Trinket
Item Number 384             Name: Metal clasp from document tie                       Age:   25 years,  167 days 	Tags: NonMagic,PocketJunk,Safe,Trinket
Item Number 385             Name: Seam scrap (glued edge)                             Age:  288 years,  212 days 	Tags: NonMagic,PocketJunk,Safe,Trinket
Item Number 386             Name: Padded strip of linen                               Age:   36 years,    5 days 	Tags: NonMagic,PocketJunk,Safe,Trinket
Item Number 387             Name: Segment of pressed foil                             Age:    2 years,  306 days 	Tags: NonMagic,PocketJunk,Safe,Trinket
Item Number 388             Name: Bit of wax thread                                   Age:  483 years,    6 days 	Tags: NonMagic,PocketJunk,Safe,Trinket
Item Number 389             Name: Partial string of mini-beads                        Age:   21 years,  225 days 	Tags: NonMagic,PocketJunk,Safe,Trinket
Item Number 390             Name: Corner of receipt slip                              Age:   10 years,  112 days 	Tags: NonMagic,PocketJunk,Safe,Trinket
Item Number 391             Name: Twisted earring post                                Age:  507 years,  276 days 	Tags: NonMagic,PocketJunk,Safe,Trinket
Item Number 392             Name: Splotch of hardened glue                            Age:    0 years,   27 days 	Tags: Important,NonMagic,PocketJunk,Remembered,Safe,Trinket
Item Number 393             Name: Ink blot sample (scrap)                             Age:    0 years,    8 days 	Tags: NonMagic,PocketJunk,Recent,Remembered,Safe,Trinket
Item Number 394             Name: Linen corner swatch                                 Age:    4 years,  123 days 	Tags: NonMagic,PocketJunk,Safe,Trinket
Item Number 395             Name: Tiny hook (brass tip)                               Age:   86 years,  129 days 	Tags: NonMagic,PocketJunk,Safe,Trinket
Item Number 396             Name: Metal eyelet punch                                  Age:    0 years,  149 days 	Tags: NonMagic,PocketJunk,Safe,Trinket
Item Number 397             Name: Cotton stitch demo scrap                            Age:    9 years,   36 days 	Tags: NonMagic,PocketJunk,Safe,Trinket
Item Number 398             Name: Piece of wire tag loop                              Age:   25 years,  218 days 	Tags: NonMagic,PocketJunk,Safe,Trinket
Item Number 399             Name: Fringe from doll clothing                           Age:    0 years,  281 days 	Tags: NonMagic,PocketJunk,Safe,Trinket
Item Number 400             Name: Cardboard corner sample                             Age:  381 years,   55 days 	Tags: NonMagic,PocketJunk,Safe,Trinket
Item Number 401             Name: Soapstone skull that hums when cold                 Age:  331 years,   15 days 	Tags: NonMagic,Safe,Sentient,Trinket
Item Number 402             Name: Pocketwatch that ticks when insulted                Age:    0 years,  203 days 	Tags: Device,NonMagic,Safe,Sentient
Item Number 403             Name: Snarky brass compass that only points west          Age:    0 years,    7 days 	Tags: Device,NonMagic,Recent,Remembered,Safe,Sentient
Item Number 404             Name: Folded letter that sighs softly                     Age:  496 years,  162 days 	Tags: NonMagic,Safe,Sentient,Trinket
Item Number 405             Name: Tiny bell that rings when ignored                   Age:   24 years,   41 days 	Tags: NonMagic,Safe,Sentient,Trinket
Item Number 406             Name: Worry stone that whispers regrets                   Age:  482 years,   94 days 	Tags: NonMagic,Safe,Sentient,Trinket
Item Number 407             Name: Needle that points at nearest tavern                Age:    0 years,  248 days 	Tags: NonMagic,Safe,Sentient,Tool
Item Number 408             Name: Coin that rattles if you lie                        Age:    0 years,  118 days 	Tags: Currency,NonMagic,Safe,Sentient,Trinket
Item Number 409             Name: Slate tile that corrects grammar                    Age:   26 years,  242 days 	Tags: NonMagic,Safe,Sentient,Trinket
Item Number 410             Name: Cork that refuses to be removed                     Age:  482 years,  310 days 	Tags: NonMagic,Safe,Sentient,Trinket
Item Number 411             Name: Eyeglass lens that winks occasionally               Age:    0 years,   26 days 	Tags: Clothing,NonMagic,Recent,Remembered,Safe,Sentient
Item Number 412             Name: Copper badge that invents titles                    Age:    4 years,   80 days 	Tags: NonMagic,Safe,Sentient,Trinket
Item Number 413             Name: Button that giggles when pressed                    Age:    0 years,    3 days 	Tags: NonMagic,Recent,Remembered,Safe,Sentient,Trinket
Item Number 414             Name: Miniature harp that plays only off-key              Age:   17 years,  278 days 	Tags: Device,NonMagic,Safe,Sentient
Item Number 415             Name: Sealed vial that insists it’s empty                 Age:  243 years,  320 days 	Tags: NonMagic,Potion,Safe,Sentient
Item Number 416             Name: Iron ring that sulks when wet                       Age:    0 years,    7 days 	Tags: Clothing,NonMagic,Recent,Remembered,Safe,Sentient
Item Number 417             Name: Silver whistle that only dogs ignore                Age:   41 years,   83 days 	Tags: Device,NonMagic,Safe,Sentient
Item Number 418             Name: Lump of wax that disapproves silently               Age:  135 years,   48 days 	Tags: NonMagic,RawMaterial,Safe,Sentient
Item Number 419             Name: Journal page that remembers nothing                 Age:    0 years,   90 days 	Tags: NonMagic,Safe,Sentient,Trinket
Item Number 420             Name: Tea cup that judges your manners                    Age:   47 years,  289 days 	Tags: Clothing,NonMagic,Safe,Sentient
Item Number 421             Name: Bronze feather that won’t stop twitching            Age:    0 years,  178 days 	Tags: NonMagic,RawMaterial,Safe,Sentient
Item Number 422             Name: Leather scrap that quotes obscure laws              Age:    7 years,  356 days 	Tags: Clothing,NonMagic,Safe,Sentient
Item Number 423             Name: Brass gear that criticizes your grip                Age:  490 years,  153 days 	Tags: NonMagic,Part,Safe,Sentient
Item Number 424             Name: Chalk nub that doodles rude gestures                Age:    0 years,    8 days 	Tags: NonMagic,Part,Recent,Remembered,Safe,Sentient
Item Number 425             Name: Twine loop that recites limericks                   Age:    8 years,  364 days 	Tags: NonMagic,Part,Safe,Sentient
Item Number 426             Name: Metal cube that hums when stared at                 Age:   75 years,   76 days 	Tags: Device,NonMagic,Safe,Sentient
Item Number 427             Name: Single shoe lace that tangles spitefully            Age:    0 years,    1 days 	Tags: Clothing,NonMagic,Recent,Remembered,Safe,Sentient
Item Number 428             Name: Tooth that tells tall tales                         Age:   16 years,  205 days 	Tags: NonMagic,Safe,Sentient,Weapon
Item Number 429             Name: Shard of mirror that flatters unconvincingly        Age:   57 years,  215 days 	Tags: NonMagic,Safe,Sentient,Trinket
Item Number 430             Name: Copper disc that makes suggestions                  Age:    2 years,  244 days 	Tags: NonMagic,Safe,Sentient,Trinket
Item Number 431             Name: Cloth patch that mumbles directions                 Age:    0 years,    5 days 	Tags: Clothing,NonMagic,Recent,Remembered,Safe,Sentient
Item Number 432             Name: Wood chip that critiques poetry                     Age:  421 years,  109 days 	Tags: NonMagic,RawMaterial,Safe,Sentient
Item Number 433             Name: Soap bubble in a jar that giggles                   Age:    0 years,   24 days 	Tags: NonMagic,Potion,Safe,Sentient
Item Number 434             Name: Stone bead that swears under its breath             Age:    0 years,   33 days 	Tags: NonMagic,Safe,Sentient,Trinket
Item Number 435             Name: Ink vial that refuses refills                       Age:   12 years,  197 days 	Tags: NonMagic,Potion,Safe,Sentient
Item Number 436             Name: Bone chip that’s “seen worse”                       Age:  457 years,  137 days 	Tags: NonMagic,Safe,Sentient,Trinket
Item Number 437             Name: Worn coin that recounts old wars                    Age:    3 years,  294 days 	Tags: Currency,NonMagic,Safe,Sentient
Item Number 438             Name: Fingernail clipping that offers advice              Age:    0 years,    2 days 	Tags: NonMagic,RawMaterial,Recent,Remembered,Safe,Sentient
Item Number 439             Name: Scarf tassel that mutters gossip                    Age:  513 years,  104 days 	Tags: Clothing,NonMagic,Safe,Sentient
Item Number 440             Name: Twig with a martyr complex                          Age:    7 years,  164 days 	Tags: NonMagic,RawMaterial,Safe,Sentient
Item Number 441             Name: Screw that grumbles during storms                   Age:    0 years,   16 days 	Tags: Important,NonMagic,Part,Remembered,Safe,Sentient
Item Number 442             Name: Knitted pouch that narrates travel logs             Age:    2 years,  314 days 	Tags: Clothing,NonMagic,Safe,Sentient
Item Number 443             Name: Ink blot that critiques fashion                     Age:    2 years,  158 days 	Tags: NonMagic,Safe,Sentient,Trinket
Item Number 444             Name: Bottlecap that hosts debates                        Age:   99 years,   84 days 	Tags: NonMagic,Safe,Sentient,Trinket
Item Number 445             Name: Paperclip that asks about your day                  Age:  100 years,    2 days 	Tags: NonMagic,Safe,Sentient,Trinket
Item Number 446             Name: Tin whistle that wheezes nervously                  Age:    0 years,    9 days 	Tags: Device,NonMagic,Recent,Remembered,Safe,Sentient
Item Number 447             Name: Bone button that shouts opinions                    Age:   42 years,  101 days 	Tags: Clothing,NonMagic,Safe,Sentient
Item Number 448             Name: Crumpled leaf that longs for autumn                 Age:  444 years,  159 days 	Tags: Nature,NonMagic,Safe,Sentient
Item Number 449             Name: Eyedropper that blinks                              Age:    0 years,  181 days 	Tags: NonMagic,Potion,Safe,Sentient
Item Number 450             Name: Unlit match that tells bedtime stories              Age:    0 years,    4 days 	Tags: NonMagic,Recent,Remembered,Safe,Sentient,Weapon
Item Number 451             Name: Half loaf of crusty bread                           Age:   53 years,  127 days 	Tags: FOOD,NonMagic,Safe
Item Number 452             Name: Wedge of hard cheese (cracked)                      Age:  238 years,  331 days 	Tags: Dangerous,FOOD,NonMagic
Item Number 453             Name: Sealed tin of smoked fish                           Age:    0 years,   51 days 	Tags: FOOD,NonMagic,Recent,Remembered,Safe
Item Number 454             Name: Dried sausage link (wrapped)                        Age:    4 years,  353 days 	Tags: FOOD,NonMagic,Safe
Item Number 455             Name: Pouch of trail mix with nuts and berries            Age:    3 years,  327 days 	Tags: FOOD,NonMagic,Safe
Item Number 456             Name: Slice of rye toast (charred edge)                   Age:    0 years,    3 days 	Tags: FOOD,NonMagic,Recent,Remembered,Safe
Item Number 457             Name: Salted meat scrap in wax paper                      Age:   17 years,  326 days 	Tags: FOOD,NonMagic,Safe
Item Number 458             Name: Wax-sealed jar of gooseberry jam                    Age:   39 years,  351 days 	Tags: FOOD,NonMagic,Safe
Item Number 459             Name: Corked bottle of red wine (aged)                    Age:  134 years,   90 days 	Tags: Dangerous,FOOD,NonMagic
Item Number 460             Name: Melted lump of honey candy                          Age:    2 years,  142 days 	Tags: FOOD,NonMagic,Safe
Item Number 461             Name: Crumb-covered slice of pie (unidentified)           Age:    0 years,    2 days 	Tags: FOOD,NonMagic,Recent,Remembered,Safe
Item Number 462             Name: Cracked biscuit with mold spots                     Age:  100 years,  201 days 	Tags: Dangerous,FOOD,NonMagic
Item Number 463             Name: Boiled egg (smeared)                                Age:    0 years,  101 days 	Tags: FOOD,NonMagic,Safe
Item Number 464             Name: Bundle of dried seaweed                             Age:    3 years,   54 days 	Tags: FOOD,NonMagic,Safe
Item Number 465             Name: Tiny wrapped caramel                                Age:    0 years,    4 days 	Tags: FOOD,NonMagic,Recent,Remembered,Safe
Item Number 466             Name: Bone-in chicken leg (cold)                          Age:    1 years,  313 days 	Tags: FOOD,NonMagic,Safe
Item Number 467             Name: Dry stick of jerky (peppered)                       Age:   24 years,  338 days 	Tags: FOOD,NonMagic,Safe
Item Number 468             Name: Crumbly hunk of blue cheese                         Age:  104 years,  161 days 	Tags: FOOD,NonMagic,Safe
Item Number 469             Name: Half-eaten meat pie (cool)                          Age:    0 years,  359 days 	Tags: FOOD,NonMagic,Safe
Item Number 470             Name: Wrapped sugar cube packet                           Age:    0 years,   24 days 	Tags: FOOD,NonMagic,Safe
Item Number 471             Name: Flatbread roll with onion flake                     Age:    0 years,    7 days 	Tags: FOOD,NonMagic,Recent,Remembered,Safe
Item Number 472             Name: Sachet of herbal tea (faded label)                  Age:  362 years,  110 days 	Tags: Dangerous,FOOD,NonMagic
Item Number 473             Name: Pickled egg in cloudy brine                         Age:   28 years,  319 days 	Tags: FOOD,NonMagic,Safe
Item Number 474             Name: Bottle of plum liquor (half-full)                   Age:   24 years,   61 days 	Tags: FOOD,NonMagic,Safe
Item Number 475             Name: Chunk of stale sponge cake                          Age:    4 years,  271 days 	Tags: FOOD,NonMagic,Safe
Item Number 476             Name: Folded pastry with fruit filling                    Age:    5 years,  299 days 	Tags: FOOD,NonMagic,Safe
Item Number 477             Name: Clay-sealed jar of olives                           Age:  183 years,  224 days 	Tags: FOOD,NonMagic,Safe
Item Number 478             Name: Tin cup of stew grease (solid)                      Age:  501 years,  182 days 	Tags: Dangerous,FOOD,NonMagic
Item Number 479             Name: Bundle of wrapped taffy (various colors)            Age:    0 years,   18 days 	Tags: FOOD,NonMagic,Recent,Remembered,Safe
Item Number 480             Name: Brown apple slice (soft)                            Age:    2 years,  109 days 	Tags: FOOD,NonMagic,Safe
Item Number 481             Name: Cracked plate with soup residue                     Age:    3 years,  128 days 	Tags: FOOD,NonMagic,Safe
Item Number 482             Name: Waxy chunk of smoked cheese                         Age:  117 years,  199 days 	Tags: FOOD,NonMagic,Safe
Item Number 483             Name: Cup of cold porridge (with spoon)                   Age:    0 years,   35 days 	Tags: FOOD,NonMagic,Safe
Item Number 484             Name: Flask of thick mushroom broth                       Age:   40 years,  122 days 	Tags: FOOD,NonMagic,Safe
Item Number 485             Name: Dried fig (wrinkled)                                Age:   10 years,  160 days 	Tags: FOOD,NonMagic,Safe
Item Number 486             Name: Bag of stale peanuts (salted)                       Age:   16 years,  297 days 	Tags: FOOD,NonMagic,Safe
Item Number 487             Name: Strip of eel jerky                                  Age:   42 years,  257 days 	Tags: FOOD,NonMagic,Safe
Item Number 488             Name: Tin of preserved lemon wedges                       Age:    0 years,    5 days 	Tags: FOOD,NonMagic,Safe
Item Number 489             Name: Small meat skewer (grilled)                         Age:    0 years,   62 days 	Tags: FOOD,NonMagic,Safe
Item Number 490             Name: Box of powdered sugar cubes                         Age:   10 years,  222 days 	Tags: FOOD,NonMagic,Safe
Item Number 491             Name: Wedge of dragonfruit (dried)                        Age:    9 years,  159 days 	Tags: FOOD,NonMagic,Safe
Item Number 492             Name: Jar of pickled cabbage                              Age:    4 years,  354 days 	Tags: FOOD,NonMagic,Safe
Item Number 493             Name: Wrapped meat dumpling (cold)                        Age:    3 years,  293 days 	Tags: FOOD,NonMagic,Safe
Item Number 494             Name: Cracked ceramic dish of baked beans                 Age:    1 years,   85 days 	Tags: FOOD,NonMagic,Safe
Item Number 495             Name: Old soup bone (licked clean)                        Age:  106 years,   22 days 	Tags: Dangerous,FOOD,NonMagic
Item Number 496             Name: Rusted flask of clear liquor                        Age:  226 years,  153 days 	Tags: Dangerous,FOOD,NonMagic
Item Number 497             Name: Folded paper bag with popcorn kernels               Age:    0 years,  263 days 	Tags: FOOD,NonMagic,Safe
Item Number 498             Name: Cloth bundle of boiled potatoes                     Age:    5 years,  107 days 	Tags: FOOD,NonMagic,Safe
Item Number 499             Name: Stale bread crust (gnawed)                          Age:    2 years,  310 days 	Tags: FOOD,NonMagic,Safe
Item Number 500             Name: Corked bottle labeled “beet cordial”                Age:  216 years,  300 days 	Tags: Dangerous,FOOD,NonMagic
